--------------------
--------------------
--------------------
--------------------
--------------------
---12222222222223---
--------------------
--------------------
--------------------
--------------------
-1223----------1223-
--------------------
--------------------
--------------------
--------------------
---12222222222223---
--------------------
--------------------
--------------------
--------------------